BMW	Bayerische Motoren Werke AG
Audi	AUDI Aktiengesellschaft
Volvo	AB Volvo
Toyota	Toyota Motor Corporation
Volkswagen	Volkswagen
Honda	Honda Motor Company, Ltd.
Nissan	Nissan Motor Company Ltd
Fiat	Fiat S.p.A
Suzuki	Suzuki Motor Corporation
Mazda	Mazda Motor Corporation
Chrysler	Chrysler Group LLC
Subaru	Subaru
Ferrari	Ferrari S.p.A
Bentley	Bentley Motors Limited
Porsche	Porsche Automobil Holding SE
Yamaha	Yamaha Motor Company
Kia	Kia Motors
Ford	Ford Motor Company 
Jaguar	Jaguar Cars Ltd.
Lexus	Lexus 
RBS bank	The Royal Bank of Scotland plc
Barclays	Barclays PLC
HSBC	HSBC Holdings plc
Bank of America	Bank of America Corporation
Wells Fargo	Wells Fargo & Company
PNC	PNC Financial Services Group, Inc.
Capital One	Capital One Financial Corporation
Banco Santander	Banco Santander, S.A.
Bankia	Bankia S.A.
BBVA	Banco Bilbao Vizcaya Argentaria, S.A.
Goldman Sachs	The Goldman Sachs Group, Inc
Apple
